Audio/DummyType.define:	/D "USEDT"
Audio/AudioSignature.define:	/D "USEAST"
Audio/MelodySequence.define:	/D "USEMSQ"
Audio/AudioSpectralFlatness.define:	/D "USESFM"
Video/MotionTrajectory.define:	/D "USEMT"
Video/TemporalInterpolation.define:	/D "USETI"
Video/ScalableColor.define:	/D "USESCC"
Video/DummyType.define:	/D "USEDT"
Video/ColorStructure.define:	/D "USECT"
Video/SpatioTemporalLocator.define:	/D "USESTL"
Video/TextureBrowsing.define:	/D "USETB"
Video/RegionLocator.define:	/D "USERL"
Video/ContourShape.define:	/D "USESC"
Video/TimeSeries.define:	/D "USETS"
Video/ColorLayout.define:	/D "USECL"
Video/MultiView.define:	/D "USE2D3D"
Video/ParametricObjectMotion.define:	/D "USEPOM"
Video/HomoTexture.define:	/D "USEHT"
Video/GoFGoPColor.define:	/D "USEGF"
Video/RegionShape.define:	/D "USESR"
Video/MotionActivity.define:	/D "USEMA"
Video/DominantColor.define:	/D "USEDC"
Video/3DShapeSpectrum.define:	/D "USE3DSS"
Video/Spatial2DCoordinates.define:	/D "USES2D"
Video/MultiImage.define:	/D "USEMI"
Video/FaceRecognition.define:	/D "USEFR"
Video/EdgeHistogram.define:	/D "USEEH"
MDS/VideoEditing.define:	/D "USEVE"
MDS/SoundProperty.define:	/D "USESP"
MDS/StateMember.define:	/D "USESTM"
MDS/InkSegment.define:	/D "USEINK"
MDS/Model.define:	/D "USEMO"
MDS/SequentialSummary.define:	/D "USESSZ"
MDS/PointOfView.define:	/D "USEPOV"
MDS/Vector.define:	
MDS/Summarization.define:	/D "USESZ"
MDS/PhoneticTranslationHints.define:	/D "USEPTH"
MDS/DSDummyType.define:	/D "USEDTDS"
MDS/SpaceFrequencyView.define:	/D "USESF"
MDS/Variation.define:	/D "USEVA"
MDS/AffectiveSegmentFilter.define:	/D "USEASF"
MDS/Time.define:	/D "USETM"
MDS/SpatialResolutionHint.define:	/D "USESRH"
MDS/MatchingHint.define:	/D "USEMH"
MDS/HierarchicalKeyFrame.define:	/D "USEHS"
MDS/MediaMeta.define:	/D "USEMM"
MDS/UserPreference.define:	/D "USEUP"
MDS/SummaryPreferences.define:	/D "USESPR"
MDS/OrderingKey.define:	/D "USEODK"
MDS/TranscodingHints.define:	/D "USETH"
MDS/Mosaic.define:	/D "USEMK"
MDS/StructuredCollection.define:	/D "USESTC"
MDS/Package.define:	/D "USEPACK"
MDS/DependStructure.define:	/D "USEDPS"
MDS/GraphicalCS.define:	/D "USEGCS"
MDS/ExtendedTextualType.define:	/D "USEETT"
MDS/VideoText.define:	/D "USEVT"
MDS/SeqSummaryKeywords.define:	/D "USESKW"
MDS/MediaReview.define:	/D "USEMR"
MDS/SeqSummaryFastMovingStoryBoard.define:	/D "USESMS"
MDS/MediaQuality.define:	/D "USEMQ"
MDS/StateTransitionModel.define:	/D "USESTX"
MDS/Semantic.define:	/D "USESEM"
MDS/Segment.define:	/D "USESG"
MDS/SegmentRelGraph.define:	/D "USESRG"
MDS/ImportanceHint.define:	/D "USEIMH"
